20,11
####################
#       #S         #
# ##### ########## #
#     #            #
##### ##############
#     #            #
# ### # ########## #
# #   #         E# #
# ### ############ #
#   #              #
####################